11111111111
10P000011C1
10E00100101
1C0C0000001
11111111111
