11111111111
10P010C01C1
1C101100101
1E0C000C001
11111111111
