1111111111
1C0P0E0001
1111111111
