1111111111
10000P0001
1C00C00111
110C100001
1000E00101
1111111111
