1111111111111111111
10000000C0011111
1000111000011
10001P10000111
10E01110000111111
111111111111111
