11111
10P01
11E11
1C001
11111
