11111
10P01
11E11
1CCC1
11111
